################################
#...   .##..##.....########....#
#......              ...######.#
#..     .....              ....#
#..............................#
#..  ...#........##...     ....#
#........    ...#####..........#
#....##....#..###....#.....##..#
#......................##......#
#.....#.......#...    .........#
#.......#.....#.........######.#
#...    ......###.......#......#
#..###..........#.......#..###.#
#....#... ..    ..#.. ..#..##..#
#....#... ......#.......#......#
#..#..... .##..      ..........#
#..#..... ...............#.....#
#..#.....#......###......#.#...#
#..#    .........  ......#.....#
#..#........#..................x
#..#.#.....#.....######..#.  ..#
#..#...#...#..........#..#.. ..#
#........#......#.....#..#.. ..#
#..          .........####.. ..#
#....#......#####..............#
#...............#.....####.....#
#....#...   ....#.........#....#
#..###..........#.... . ..#....#
#...      .....#...####...#....#
#..........#.#.#.#........#....#
#....K....##.....#..#..........#
############################x###