################################
#...   ....#......#............#
#......    #         ....#.....#
#......#####..####.............#
#..........#............##.....#
x..  ...#..#.....##...     ....#
#........  # .......#..........#
#....##....#.........#.........#
#..........#...........##......#
#.....#....#..#................#
#.......#.....#.........######.#
#..........#..###.......#......#
#..###.....#....#.......#......#
#....#... .#....#.......#..K...#
#....#... .#....#########......#
#...  ... .#...      ....#######
#........ .#.............#.....#
#.  ## ..#.#....###......#.....#
#...    ...#.....  ......#.....#
#..........##....##########....#
#....#.....#.....######..#.  ..#
#..........#..........#..#.. ..#
#..   ...#.#....#.....#..#.. ..#
#..........#..........####.. ..Q
#....#.....#...................#
#..........#....###########....#
#....#...  #....#.........#....#
#..........#....#.... . ..#....#
#...      .#...#...###....#....#
#..........#.#.#.#........#....#
#.........##.....#..#..........#
##################x#############