##########################x#####
#...   ...........#............#
#......              ....#.....#
#......####...####.............#
#............##.........##.....#
#..  ...#........##...     ....#
#........    ....#..#..........#
#....##..........#...#.........#
#................#.....##......#
#.....#.......#..#.............#
#.......#.....#..#......######.#
#.............###.......#......#
#..###..........#.......#......#
#....#... ......#.......#......#
#....#... ......#########......#
#........ .....      ....#######
########## . #############.....#
#........#......###......#.....#
#...    .........  ......#.....#
#...........#..................#
#....#...........######..#.  ..#
#....#................#..#.. ..#
#....#...#......#.....#..#.. ..#
#....#................####.. ..#
#....#..#####..................#
x....#.#######..###########....#
#....#...   . . #.    #...#....#
#...............#.... . ..#....#
#...      .....#..........#....#
#..........#.#.#.#........#....#
#.........##.....#..#..........#
##############x#################