##x#############################
#...   .##..##.....########....#
#...#..              ...######.#
#.. #   .....              ....#
#...#..........................#
#.. #...#........##...     ....#
#...#....    ...#####..........#
#....##....#..###....#.....##..#
#...................#..##......#
#.....#.......#...  # .........#
#.......#.....#.....#...######.#
#...    ......###...#...#......#
#..###..........#...#...#..###.#
x....#... ..    ..#.# ..#..##..#
#....#... ......#...#...#......#
#..#..... .##..     #..........#
#..#..... ..........#....#.....#
#..#.....#......###.#....#.#...#
#..#    .........  .#....#.....#
#..#........#.......#..........#
#..#.#.....#.....######..#.  ..#
#..#...#...#........#.#..#.. ..#
#........#......#...#.#..#.. ..#
#..          .......#.####.. ..#
#....#......#####...#..........#
###########.##..#...#.####.   .#
#....#...   ....#...#.....#....#
#..###..........#...# . ..#....#
#...      .....#...####...#....#
#..........#.#.#.#..#.....#....#
#.........##.....#..#..........#
################################