################################
#...   ...........#............#
#......              ....#.....#
#......####...  ##.............x
#.......................##.....#
#..  ...#........##...     ....#
#........    .......#..........#
#....##..............#.........#
#......................##......#
#.....#.......#................#
#.......#.....#.........#...##.#
#.............###.......#......#
#..###..........#.......#......#
#....#... ......#.......#......#
#....#... ......###   ###......#
#........ .....      ....###  ##
#........ ...............#.....#
#........#......###......#.....#
#...    .........  ......#.....#
#...........#..................#
#....#...........#..###..#.  ..#
#.....................#..#.. ..#
#........#......#.....#..#.. ..#
#.....................####.. ..#
#....#.........................#
#...............###      ##....#
#....#...   ....#.........#....#
#...............#.... . ..#....#
#...      .....#..........#....#
x..........#.#.#.#........#....#
#.........##.....#..#..........#
######x#########################