#######################x########
#...   ...........#............#
#......              ....#.....#
#......####...  ##.............#
#...........    ...##....     .#
#..  ...#..... ..##...     ....#
#........    .     .#..........#
#....##..............#.........#
x......     ####.......##......#
#.....#.......#....         ...#
#.......#.....#.........#...##.#
#.......    ..###.......#......#
#..###..    ....#.......#......x
#....#... ......#.......#......#
#....#... ......###   ###......#
#........ .....      ....###  ##
# # # # # ...............#.....#
#........#......###......#.....#
#...    .........  ......#.....#
#...........#   ###   .........#
#....#...........#..###..#.  ..#
#.....................#..#.. ..#
#........#......#.....#..#.. ..#
#...      #######   ..####.. ..#
#....#.........................#
#....###   .....###      ##....#
#....#...   ....#... .....#....#
#...............#...  . ..#....#
#...      .....#.... .....#....#
#..........#.#.#.#.. .   .#....#
#.........##.....#..#..........#
################################