#####################x##########
#...   ...........#............#
#......              ....#.....#
#.. . . . . . . . . . .. . . . #
#. . . . . . . . . . . . . . . #
#..  ...#......................x
#........    ....#..#. # # # # #
#....##..........#...#.........#
#................#.....##......#
#.....#.......#..#.... . . ....#
#.......#.....#..#......##   #.#
#.............###.......#......#
#..###...       #.......#......#
#....#... ......#.......#......#
#....#... ......# . . ###......#
#........ .....      ....# . . #
### .    ## . ##. . . ####.....#
#........#......###......#.....#
#...    .........  ......#.....#
#...........#..................#
x...    .........######..#.  ..#
#....#................#..#.. ..#
#..  #...#......#.....#..#.. ..#
#...    ..............####.. ..#
#  ..#..#####..................#
#....#.# . .##..##     .###....#
#..  #...   . . #.    #...#....#
#...##  #     ..#.... . ..#....#
#...      .....#..........#....#
#..........#.#.#.#........#....#
#.........##.....#..#..........#
######x#########################