#########################x######
#.........................     #
##########               .     #
#                        .     #
#              ...........     #
#              .               #
#              ......          #
#                   .          #
#                   .          #
#                   .          #
#            #######.######    #
#            #............#    #
#            #............#    #
#            #............#    #
#            #............#    #
#            #............#    #
#.........................#    #
#            #............#    #
#            #............#    #
#            ##.###########    #
#              .               #
#            ...               #
#            .                 #
#            .                 #
#            .........         #
#                    .         #
#                    .         #
#                    .....     #
#                        ......x
#                              #
#                              #
################################