############x###################
#...   ...........#............#
#......              ....#.....#
#......####...####.............#
#.......................##.....#
#..  ...#........##...     ....#
#........    .......#..........#
#....##..............#.........#
#......................##......#
#.....#.......#................#
#.......#.....#.........######.#
#.............###.......#......#
#..###..........#.......#......#
#....#... ......#.......#......#
#....#... ......#########......x
#........ .....      ....#######
#........ ...............#.....#
#........#......###......#.....#
#...    .........  ......#.....#
#...........#..................#
#....#...........######..#.  ..#
#.....................#..#.. ..#
#........#......#.....#..#.. ..#
#.....................####.. ..#
#....#.........................#
#...............###########....#
#....#...   ....#.........#....#
#...............#.... . ..#....#
#...      .....#..........#....#
#..........#.#.#.#........#....#
#.........##.....#..#..........#
#######################x########